1,1,1,1,1
1,1,1,2,2
1,1,2,2,3
1,2,2,3,3
1,2,3,3,4
1,2,3,4,5
2,3,3,4,5
3,3,4,4,5
3,4,4,5,5
4,4,5,5,5
5,5,5,5,5